NO ./path_north.xpm
SO ./path_south.xpm
WE ./path_west.xpm
EA ./path_east.xpm
F 220,100,0
C 225,30,0

111111
100001
1010N1
111111