NO ./maps/path_north.xpm
SO ./maps/path_south.xpm
WE ./maps/path_west.xpm
EA ./maps/path_east.xpm
F 220,100,0
C 225,30,0

111111
10W001
1010N1
111111