LA ./textures/path_north.xpm
SO ./textures/path_south.xpm
WE ./textures/path_west.xpm
EA ./textures/path_east.xpm
F 220,100,0
C 225,30,0

111111
10001
10001
1S0001
111111

