NO ./textures/north.xpm
SO ./textures/south.xpm
WE ./textures/west.xpm
EA ./textures/east.xpm

F 30, 30, 40
C 10, 10, 40

111111111111111111111
101000001000000000001
101010101011111110001
100010100010000010001
111110101111101011101
100000101000101000001
1011111010N0110111111
101000001000100000101
101011111000111110101
101010001000100010101
101110101000101010101
10000010000001010001
111111101001111011101
100000101000100010001
101110101110101110111
101000100000100010101
101011111111111010101
100010000000000010001
101010111011111111101
101000001000000000001
111111111111111111111