NO ./textures/north.xpm
SO ./textures/south.xpm
WE ./textures/west.xpm
EA ./textures/east.xpm

F 220,100,0
C 100,150,200

111111111111
1000000011111
100S0000000001
1000010011111
1000000000001
1111111111111
