NO ./textures/north.xpm
SO ./textures/south.xpm
WE ./textures/west.xpm
EA ./textures/east.xpm

F 30, 30, 40
C 10, 10, 40

1111111111111
1000000000001
1011110111101
1010000100001
1010111110111
1010000000011
1011111110101
1000100010101
1110111010101
10000000000001
101111110N111
1000000000001
1111111111111