NO ./textures/north.
SO ./textures/south.xpm
WE ./textures/west.xpm
EA ./textures/east.xpm

F 220,100,200
C 100,150,200

111111
100001
100N01
100001
111111