NO ./textures/north.xpm
SO ./textures/south.xpm
WE ./textures/west.xpm
EA ./textures/east.xpm

F 30, 30, 40
C 10, 10, 40

1111111111111
1000000000001
1011110111101
1010000100001
1010111110111
10100000N00101
1011101110101
1000100010101
1110111010101
1000000010001
1011111110111
1000000000001
1111111111111
