NO ./textures/path_north.xpm
SO ./textures/path_south.xpm
WE ./textures/path_west.xpm
EA ./textures/path_east.xpm
F 164,169,20
C 153,204,255

111111111111111111111
101000001000000000001
101010101011111110001
100010100010000010001
111110101111101011101
100000101000101000001
101111101001101111111
101000001000100000101
101011111000111110101
1010100010D0100010101
101110101000101010101
1000001000N0001010001
111111101001111011101
100000101000100010001
101110101110101110111
101000100000100010101
101011111111111010101
100010000000000010001
101010111011111111101
101000001000000000001
111111111111111111111